R 500        500
NO ./textures/bricks.xpm
SO ./textures/chiseled_sandstone.xpm
WE ./textures/gold_ore.xpm
EA ./textures/jungle_log.xpm
S           ./textures/mario.xpm
F 7,113,40
C 119 ,  181   ,           254

   1111111111111111111111111
   1000000000000000000000001
   1011111111111111111111101
   101                   101
111101111111111111111111 101
100000000000000000000001 101
100000000000000000000001 101
100000000000000000000001 101
100000111110000101010001 101
100000100010000000000001 101
100000100010000100010001 101
100000100010000000000001 101
100000110110000101010001 101
100000000000000000000001 101
1000000000000000000000011101
100000000E000000000000010001
100000000000000000000001111
100000000000000000000001
111111111000000000000201
100000001000000000000001
111101111000000000000001
110100001000000000000001
110000001000000000000001
110100001000000000000001
110111111000000000000001
110000000000000000000001
111111111000000000000001
111111111111111111111111