R 500 500
NO ./textures/others/acacia_log.xpm
SO ./textures/others/dark_oak_log.xpm
WE ./textures/others/oak_log.xpm
EA ./textures/others/spruce_log.xpm
S ./textures/others/diamond.xpm
F 7,113,40
C 119,181,254

11111111111111111111111111111111111111111111111111111111111111111111111111111111111111
10000000000000000000000000000000000000000001000000000000000000000000000000000000000001
10111111111111111111111111111111111111111100000000000000000000000000000000000000000001
10111100000000000000000000000000000000000001000000000000000000000000000000000000000001
10000101110111111111111111111111111111101101000000000000000000000000000000000000000001
11110100001000000000000000000000000000000001000000000000000000000000000000000000000001
10010101101111111110111111111111111111111101000000000000000000000000000000000000000001
10110101000000000000111111111111111111111101000000000000000000000000000000000000000001
10110101101111111111100011111111111111111101000000000000000000000000000000000000000001
101101000011111111111010111111111111111111010000000000000000000000000000000000000000E1
10110111111111111111101000011000000000111101000000000000000000002200000000000000000001
10110000000000000000001111000011111110111101000000000000000000002200000000000000000001
10110111111111111111111111111111111110111101000000000000000000002000000000000000000001
10010111111000001111000000000000000110111101000000000000000000002000000000000000000001
10110111111011101111011111111111110110111101000000000000000000001222200000000000000001
10000111111011101111000000100000010000111101000000000000000000002000000000000000000001
11011000011011101111111110100000011111011101000000000000000000002000000000000000000001
11011011011011101111111110111111100111011101000000000000000000002000000000000000000001
11011111011011101111111110000000010000011101000000000000000000002000000000000000000001
11000000010000101100001111111111010111111101000000000000000000000000000000000000000001
11111111110110101101100011111111010111111101000000000000000000000000000000000000000001
10000001000110100001111000000000010000000001000000000000000000000000000000000000000001
11111100011110111111111111111111111111111111000000000000000000000000000000000000000001
11111111111110000000000000000000000000000021000000000000000000000000000000000000000001
11111111111111111111111111111111111111111111111111111111111111111111111111111111111111