R 1280 720
NO ./textures/others/angelo.xpm
SO ./textures/others/edgar.xpm
WE ./textures/others/nathan.xpm
EA ./textures/others/fullissou.xpm
S ./textures/others/issou.xpm
F 7,113,40
C 119,181,254

   1111111111111111111111111
   1000000000000000000000001
   1011111111111111111111101
   101                   101
111101111111111111111111 101
100000000000000000000001 101
100000000000000000000001 101
100000000000000000000001 101
100000111110000101010001 101
100000100010000000000001 101
100000100010000100010001 101
100000100010000000000001 101
100000110110000101010001 101
100000000000000000000001 101
1000000000000000000000011101
1000000000000000000000000001
1000000002000000000000111111
111111111020000000000201
100000001000000002000001
11110111100E000000000001
110100001000000000000001
110000001000000000000001
110100001002220002222001
110111111002220002222001
110000000002220002222001
111111111000000000000001
111111111111111111111111