R 	480 480
R 	500 500
R 100 100
NO./textures/jungle_log.xpm
NO./textures/jungle_log.xpm
NO./textures/jungle_log.xpm
NO./textures/jungle_log.xpm
v
NO./textures/jungle_log.xpm
NO./textures/jungle_log.xpm
v
NO./textures/gold_ore.xpm
NO./textures/jung.xpm
SO./textures/gold_ore.xpm
WE./textures/chiseled_sandstone.xpm
EA./textures/bricks.xpm
S           ./textures/others/issou.xpm
F255,	255, 255
C0	,0, 0

   1111111111111111111111111
   1000000000000000000000001
   1011111111111111111111101
   101                   101
111101111111111111111111 101
100000000000000000000001 101
100000000000000000000001 101
100000000000000000000001 101
100000111110000101010001 101
100000100010000000000001 101
100000100010000100010001 101
100000100010000000000001 101
100000110110000101010001 101
100000000000000000000001 101
1000000000000000000000011101
1000000000000000000200010001
100200000N00000000222001111
100000000000000000220001
111111111000000000000201
100000001000000000000001
111101111000000000000001
110100001000000000000001
110000001000000000000001
110100001000000000000001
110111111000000000000001
110000000000000000000001
111111111000000000000001
111111111111111111111111