R 500 500
NO ./textures/jungle_log.xpm
SO ./textures/gold_ore.xpm
WE ./textures/chiseled_sandstone.xpm
EA ./textures/bricks.xpm
S  ./textures/others/issou.xpm
F 255,	255, 255
C 0	,0, 0

111111111111111111111111
100000000000000000000001
100000000000000000000001
100000000000000000000001
100000111110000101010001
100000100010000000000001
100000100010000100010001
100000100010000000000001
100000110110000101010001
100000000000000000000001
100000000000000000000001
100000000000000000000001
10000000000000002E202001
100000000000000000000001
111111111000000000000001
100000001000000000000001
111101111000000000000001
110100001000000000000001
110000001000000000000001
110100001000000000000001
110111111000000000000001
110000000000000000000001
111111111000000000000001
111111111111111111111111