R500              500            




         NO              ./textures/others/north.xpm


 SO           ./textures/others/south.xpm              

  WE  ./textures/others/west.xpm           






   
EA./textures/others/east.xpm
S           ./textures/others/ahsoka.xpm

F132,152, 177
C                            36,                    46       ,                         58                     



              			


111111111111111111111111111
10000000000000000000000000111
101110000000000000000000010001
101000000000000000000000001111
10100000111110000101010001
11100020100010000000000001
  100000100010000100010001
  100020100010000000000001
  100000110110000101010001
  100020000000000000000001
  100000000000000000000001
  100000000000000000000001
  10000000000000E020000001
  10000000000000000000000111
  11111111100000000000000001
  10000000100000000000000111
  111101111000000000000001
  110100001000000000000001
  110000001000000000000001
  110100001000000000000001
  110111111000000000000001
  110000000000000000000001
  111111111000000000000001
  1111111111111111111111111
